############
# O        #
#   P    ###
#  XX  O   #
#        ###
############