############
#        O #
#   P    ###
#          #
########   #
#   O ##   #
#     ##   #
#          #
#       XX #
#       #  #
############